1111111111111
10010000C00C1
1EC0011111001
1P0011E0000E1
1111111111111