1111111
1CCCEE1
1P001C1
1111111